+++++++++++++++++++++++++*
+-----------+-----------+*
+--+-------+++-------+--+*
+-+++-----+.+.+-----+++-+*
+--+------+.+.+------+--+*
++-+------+.+..------+-++*
.+-+-------+++.------+-+.*
.+-+--------+.+------+-+.*
.+-+--------+.+------+-+.*
++-+------+.+.+------+-++*
..---------+++---------..*
..----------+----------..*
++---------------------++*
+-----------------------+*
+------+++-----+++------+*
+------+.........+------+*
+--+---+.........+---+--+*
+-+++--+.........+--+++-+*
+--+---+++++++++++---+--+*
+--+--------+--------+--+*
+--+-------+++-------+--+*
+--+--------+--------+--+*
+-----------+-----------+*
+++++++++++++++++++++++++*

