++++++++++++++++++++++++*
+----------++----------+*
+-+++-++++-++-++++-+++-+*
+-+++-++++-++-++++-+++-+*
+----------------------+*
+-+++-+-++++++++-+-+++-+*
+-----+----++----+-----+*
+++++-++++.++.++++-+++++*
....+-+..........+-+....*
....+-+.+++..+++.+-+....*
+++++-+.+......+.+-+++++*
.....-..++++.+++........*
+++++-+.+......+.+-+++++*
....+-+.++++++++.+-+....*
....+-+..........+-+....*
+++++-+.++++++++.+-+++++*
+----------++----------+*
+-+++-++++-++-++++-+++-+*
+---+--------------+---+*
+++-+-+-++++++++-+-+-+++*
+-----+----++----+-----+*
+-++++++++-++-++++++++-+*
+----------------------+*
++++++++++++++++++++++++*
