++++++++++++++++++++++++*
.......++------++.......*
.......++--++--++.......*
++++++.++-++++-++.++++++*
+----------++----------+*
+-++++++-+-++-+-++++++-+*
+-+------+----+------+-+*
+-+-++++.++++++.++++-+-+*
+------+........+------+*
++++++-+.++..++.+-++++++*
+------+.+....+.+------+*
+-++++-+.+....+.+-++++-+*
+----+-..+....+..-+----+*
+--+---..++++++..---+--+*
++++-+-+........+-+-++++*
...+-+-+++.++.+++-+-+...*
...+-------++-------+...*
++++-+++++-++-+++++-++++*
....----+------+----....*
....-+--+--++--+--+-....*
++++-+--+-++++-+--+-++++*
+----+-----++-----+----+*
+-++++-+++-++-+++-++++-+*
+----------------------+*
++++++++++++++++++++++++*